0000000000
0201110000
0001110000
0001110000
0000000000
0000000000
0011100000
0011100000
0011103000
0000000000