0000100000
0200100300
0000100000
1111111111
0000000000
0000000000
0011100000
0011100000
0011100000
0000000000